Bath I/O PLC Framework

System:
CDT		Cycle, Clock, Date and Time Function
Prt		Protocol Function ???

Control Modules;
Act		Actuator
Sig		Signal (Digital); SpI
-AnI	Analog Input > Value
-AnO	Analog Output ???
Val		Value Processing
Set		Setpoint Processing
Out		Output Processing
PID		PID Controller
VLT		VLT
-Swi	> Signal

Action Management:
EVM		Event Manager		

Sequence Management:
Seq		Sequencer
Par		Parameter Manager
Rec		Recipe Manager
...

Data Collectors:
NtC		Notice Collector
PDC		Process Data Collector
BDC		Batch Data Collector

Functions:
Map		Value Remapping (Rescaling)
Con		Value Constrain
Flt		Filter
PWM		Pulse Width Modulator
Pow		Calculate y to the Power of x

Standard Signals and Names
Ini		Initialise
Set		Settings
Run		
Stp		Stop
Fin		Finalise

S	Set | Start	
R	Reset | Stop
P	Pause | Halt

V	Val		Value
Sp			Setpoint
S	Sig		Signal

On
Off

// Alarms are Logged and Visible on Screen
Alm		Alarm
EAlm	Enable Alarm Evaluation
AlmS	Alarm Saved
AlmTOnSP	Alarm Time Delay Setpoint
AlmTOnV		Alarm Time Delay Value

// Warnings are Visible on Screen
Wrn		Warning
WrnTOnSP	Warning Time Delay Setpoint
WrnTOnV		Warning Time Delay Value

// Information is Visible in dedicated spaces
Inf		Information


WDT		Watch Dog Timer?

T 	Tim		Time(r)
TOn		Time On
TOff		Time Off

TOnSp
TOnV

// Value Comparisson
MAX	Maximum
HH	High High
H	High
L	Low  
LL	Low Low 
MIN Minimum

MAXV	Maximum Value
HHV	High High Value
HSc	High Scale
HV	High Value
LV	Low Value 
LSc	Low Scale
LLV	Low Low Value
MINV	Minimum Value

MAXS	Maximum Signal
HHS	High High Signal
HS	High Signal
LS	Low Signal 
LLS	Low Low Signal
MINS	Minimum Signal

// Statistics
Stat

Avg		Average
Cnt		Counter
Sum		Sum
Med		Median
Min
Max
AvgCnt	Average Counter
AvgSum	Avrage Sum

